$(	upos=.
$[	upos=.
$,	upos=.
$.	upos=.
ADJA	upos=ADJ
ADJD	upos=ADJ
ADV	upos=ADV
APPO	upos=ADP
APPR	upos=ADP
APPRART	upos=ADP
APZR	upos=ADP
ART	upos=DET
CARD	upos=NUM
FM	upos=X
ITJ	upos=X
KOKOM	upos=CONJ
KON	upos=CONJ
KOUI	upos=CONJ
KOUS	upos=CONJ
NE	upos=NOUN
NN	upos=NOUN
NNE	upos=NOUN
PDAT	upos=PRON
PDS	upos=PRON
PIAT	upos=PRON
PIS	upos=PRON
PPER	upos=PRON
PPOSAT	upos=PRON
PPOSS	upos=PRON
PRELAT	upos=PRON
PRELS	upos=PRON
PRF	upos=PRON
PROAV	upos=PRON
PTKA	upos=PRT
PTKANT	upos=PRT
PTKNEG	upos=PRT
PTKVZ	upos=PRT
PTKZU	upos=PRT
PWAT	upos=PRON
PWAV	upos=PRON
PWS	upos=PRON
TRUNC	upos=X
VAFIN	upos=VERB
VAIMP	upos=VERB
VAINF	upos=VERB
VAPP	upos=VERB
VMFIN	upos=VERB
VMINF	upos=VERB
VMPP	upos=VERB
VVFIN	upos=VERB
VVIMP	upos=VERB
VVINF	upos=VERB
VVIZU	upos=VERB
VVPP	upos=VERB
XY	upos=X